25
############# ###########
#   #       # #     #   #
# # # ##### # # # # # # #
# #   #   # # # # #   # #
# ### # # # # # # ##### #
#   # # # # #   #     # #
### # # # # ######### # #
#   # #     #     #   # #
# # # ####### ### # # # #
# # # #         #   #   #
# # # # ####### #########
#   # #     #     #     #
##### ##### # ### # ### #
#   #     #     # # #   #
# # ##### ##### # # # ###
# # #     #     # # #   #
# # # ##### ##### # ### #
# # #       #     #   # #
# # ##### ### ##### # # #
# #       #       # # # #
# # ####### # ### # # # #
# #   #     # #   #   # #
# ### # # ### # ####### #
#       #     #         #
############# ###########
