25
########### #############
#   #         #   #     #
# # # # ##### # # # ### #
# #   #       # #     # #
# # ######### # ##### # #
# #   #     # # #   #   #
# ### # # # # # # # ### #
#   #   # #   # # #   # #
# # ##### ### # # ### # #
# #     #   # #         #
# # ### ### # ####### ###
# #     #   # #   #     #
# ##### # ### # # # ### #
# #   # # #   # # # #   #
# # # # # # # # # # # # #
# # # # # # #     #   # #
# # # # # # ####### ### #
# # # # # #     #   #   #
# # # # # ##### # ### # #
# # #   #   #   #     # #
# # ### ### # ######### #
# # #   #     #     #   #
# # # ### # ### ### # # #
#   #     #           # #
####################### #
