25
#######E#################
#     #         #       #
# # # # ### ### # # ### #
# # # # #   #   # # #   #
# # # # # ### ### # # # #
#   #   # #         # # #
####### # # # ####### # #
#   #   # # #       # # #
# # # ### # ####### # # #
# # #     #         # # #
#   # ### # ### ### # # #
# # # #   #   #   #   # #
### # # ##### ### ##### #
#   # #   #           # #
# # # ### # # ####### # #
# # #   #   # #     # # #
# # ### ##### # ### # # #
# #   #     #       #   #
# # # ##### #############
# # #       #           #
# # ####### # # ####### #
# #   #     # # #       #
# ### # ##### # # ##### #
#     #       #   #     #
###################P#####
