25
################# #######
#             #         #
# # ####### # # # ### # #
# #   #   # # # # #   # #
# ### # # # # # # # ### #
# #   # # #   #   #     #
# # # # # ### ### #######
# # # # #     #         #
# # # # ####### ####### #
# # # #     #   #   #   #
# # # # ### # # # # # ###
# # # #     # # # # #   #
# # # ####### # # # ### #
#   #       # #   #     #
##### ##### # ##### ### #
#   # #     #     # #   #
# # # # ######### # # ###
# # # #     #     # #   #
# # # ##### # # ### ### #
# # # #     # #   # #   #
# # # # ### # ### # # ###
# # #   #   #   # #     #
# # ### # ### # # ##### #
#       #     #         #
########### #############
