63
############################# #################################
#   #         # #     #         #   #       #   #     #   #   #
### # # ##### # # ### # ####### # # # ##### # # # ### # # # # #
#   # #   #   # # #   #       # # #   #   # # #   # # # # # # #
# # ##### # ### # # ######### ### ##### # # # # ### # # # # ###
# # #   # # #   # #   #     # #   #   # # # # # #   # # #     #
# # # # ### # # # ### # ### # # # # ### # # ### # # # # ##### #
# #   # #     # # #   # #   # # # #   # # #     # # # #     # #
# ##### # ##### # # ### ##### # ### # # # ####### ### ##### # #
#     #   #   #   # # #       #     # # #   #     #     #   # #
##### ##### ####### # ##### ##### # ### ### ### ### ### ##### #
#   #       #     #       #   # # #     # #   #   # #   #   # #
# # ####### # ### ####### # # # # ####### ### ### # # ### # # #
# #         # #           # # #         #   #   #   #   # # # #
# ##### ##### # ############# ######### # # ### ####### # # # #
#   #   #   # # #     #     # #       # # #   #     #   # #   #
# ### ##### # ### ### # # # # # ### ### # # ####### # ### #####
# #   #   #       # # # # # #   # # #   # #       # #     #   #
### # # # ##### ### # # ### ##### # # ### ### ### # ##### # # #
#   # # #     #   # # #   #   #     #   #   #   # #     # # # #
# ### # ##### ### # # ### # ### ######### # ##### ####### # # #
#   # #     #       # #   #     #   #     #     # #     # # # #
### # ##### ######### # ########### # ######### # # ### # ### #
#   #     #   #   #   # #         # # #     #   # #   # #     #
# ########### ### # ### # ####### # # # ### # ### ### # ##### #
# #       # #     # #   #   #   #   #     # # #   #   #     # #
# # ### # # ####### # ##### # # ########### # # ### ### ### # #
# #   # #   #     #   #   #   #   #         # # # #   # #     #
# ### # ### # ### ##### # ####### # ########### # ### # # #####
# #   #   # #   #       #       #         #     #   # # #   # #
# ### ##### ### ######### ### ########### # ##### # # # ### # #
#     #   #   #         #   # #   #       #     # # # # #   # #
# ##### # ### ### ######### ### # ####### ##### # # # # # ### #
# #     # # #   #       #   #   #       #     # # # # # #     #
# # ##### # ### ####### # ### ######### ##### # ### # #########
# #     # #   #         #   # #         #     #     #       # #
# ##### # # # ######### ### # # ####### # ##### ########### # #
#   # # #   #   #     # # #   # #     # #   #   #   #   #   # #
### # # ####### # ### # # ##### # ### # ### ##### # # # # # # #
#   # #     #   #   #   #       # # #   #       # #   # # # # #
# ### # ##### ##### ##### ####### # ##### ### ### ##### # ### #
# #   # #   #   #     # #   #   #     #   # #       #   #     #
# # ### # # # # ##### # ### # ####### # ### ######### # ##### #
# #     # # # #       # #   #     #     #   #         #     # #
### ##### ### ##### ### # ##### # ####### ######### ######### #
#   # #   #   #     # #   #     # #     #   #     #           #
# ### # ### ### ##### # ### ##### # ####### # # ########### ###
#     # #     # #   # # # #   #   #       #   #   #   #     # #
### ### ##### # # # # # # ### # ####### # ####### # ### ##### #
# #   #   #   #   #   # #     #     #   #         #     #     #
# ### # # # ########### # ######### # ####### ####### ### # ###
#     # # # #         #   #   #   # # #       #       # # #   #
# ####### # # ####### ####### # # # # # ####### ####### # ### #
#       #   # #   #   #       # # # # #     #   #     # #   # #
### ### # # # # # # ### # ##### ### # ####### ### ### # ### # #
# #   # # # # # # #     # #   #   # #       #   # #   #   # # #
# ### # ### ### # ####### # # # # # ####### # ### # ##### # # #
# #   #   #   # #       #   # # # # #     # #     # #   # # # #
# # ### # ### ### ##### ##### # # # # ### # ####### # # # # # #
# # #   #   #     #   # #     # #     #   #       # # # #   # #
# # # ##### ######### # # ############# ##### ### # # # ##### #
#   #     #           #               #       #   #   #       #
############################################################# #