25
########### #############
#     # #   #           #
# ### # # # ### ####### #
# #   # # # #   #   #   #
# # ### # # # # # # ### #
# # #     #   #   #   # #
# # # ############### ###
# # #   #   #   #   #   #
### ### # # # # # # ### #
#     #   # # # # #   # #
# ######### # # ### ### #
#     #     # #   #     #
##### # ##### ### ### # #
#     #     # # #   # # #
# # ####### # # ### # # #
# #       #   # #   # # #
######### ### # ##### ###
#         # #   #   #   #
# ####### # ##### # ### #
#       #         #   # #
####### ########### # # #
#   #   #         # #   #
# ### ########### # #####
#                 #     #
############### #########
