25
#########################
#       #           #   #
# ##### ####### ### # # #
# #   #   #   # #     # #
# # # # # # # # # ##### #
# # #   #   #   #     # #
# ##################### #
#   #       #         # #
### # ##### ######### # #
#   # #   #   #     # # #
# ### # # ### # ### # # #
#     # #     # # #     #
####### # ##### # #######
#     # #     #     #   #
# ### # ##### ##### ### #
# # #   #   #     #     #
# # # ### # ##### #######
#   #     # #   # #     #
# ######### ### # ##### #
# #     #   #   #       #
# ##### # ### ##### #####
# #   # #   # #   #   # #
# # # # # # # # # ### # #
#   #   # #   # #       #
#################P#######
