############# ###########
#     #     # #     #   #
# ### # ### # # # # # # #
#     # #   # # # #   # #
# ### # # # # # # ##### #
# #   #   #   #       # #
# # ##### ####### ### # #
# # #   #       # #   # #
# # # # ####### # # # # #
#   # #     #   # # # # #
# ### ##### # ### # # # #
#   #   #   # #   #   # #
# # ### # # # # ##### # #
# #       # # #   #   # #
# ######### # ### # ### #
# #         # #   # #   #
# # ####### # # ### # # #
# # #   #   #   #   # # #
# # # # # ####### # # # #
# #   # #     #   # # # #
# # ### # ### # ### # # #
# #   # # #   # #   #   #
# ### # # # # # # ##### #
#     #     #     #     #
################### #####
