##### ###################
#   #             #     #
# # ############# # ### #
# # #   #       #   #   #
# # # # # # ### ### # # #
# #   # # # #     #   # #
# ##### # # # ### ##### #
#     # # # #         # #
##### # # # ######### # #
#   # #   # #     #   # #
# # # # ### # ### # ### #
# # # # #   #     #     #
# # # # # # # ######### #
#   #   # #         #   #
### # ### ######### # ###
#   #         #   # #   #
# # ######### # # # ### #
# #   #         #     # #
# ### # # ########### # #
# #   # # #           # #
# # # # # # ##### ##### #
# # #   #   #     #     #
# # ######### # ### ### #
# #           #         #
# #######################
